EEEEEEEEEEEEEEEEEEEEEEEE
EBBBBBBBBBBBBBBBBBBBBBBB
EBEEEEEEEEBEEBEEEEEEEEEB
EBEEEEEEEEBEEBEEEEEEEEEB
EBEEEEEEEEBEEBEEEEEEEEEB
EBBBBBBBBBBEEBBBBBBBBBBB
EBEEEEEEEEEEEEEEEEEEEEEB
EBEEEEEEEEEEEEEEPEEEEEEB
EBBBBBBBBBBEEBBBBBBBBBBB
EBEEEEEEEEBEEBEEEEEEEEEB
EBEEEEEEEEBEEBEEEEEEEEEB
EBEEEEEEEEBEEBEEEEEEEEEB
EBEEEEEEEEBEEBEEEEEEEEEB
EBEEEEEEEEBEEBEEEEEEEEEB
EBEEEEEEEEBEEBEEEEEEEEEB
EBBBBBBBBBBBBBBBBBBBBBBB