BBBBBBBBBBBBBBBBBBBBBBB
B_____________________B
B_____________________B
B_____________________B
B____E______P_________B
B_____________E_______B
B_____________________B
B_____________________B
BBBBBBBBBBBBBBBBBBBBBBB