_________________________
_AAAAABBBBBBBBBBBBBAAAAA_
__E_______B__B______E____
__________B__B___E_______
_B____E___B__B_________B_
_BBBBB___BB__BBB___BBBBB_
_B_____W___R_R____W____B_
_B_____W__________W____B_
_B_____________________B_
_BBBAAABBBB__BBBB__ABBBA_
_B________B__B_________B_
_B________B__BBBB______B_
_B_____________________B_
_B_____BBBB__BBBB______B_
___WW______________WW____
_A_________WWW______PH_A_
_________________________
_BBBAAAABBBBBBBBBAAAABBB_